The Cove
An Interactive Fiction by Will Geller
Release 1 / Serial number 221125 / Inform 7 v10.1.2 / D

The Boat
You are adrift a ship with no food and no sail, a storm has sent you close to land... to the west is the beach...

>go north
Darkness
It is pitch dark, and you can't see a thing.

You see a faint glow coming form a light switch.

There are 20 minutes to escape!

>click light
That's not a verb I recognise.

>switch light
You switch the light switch on.

There are 20 minutes to escape!

Living Room
There is a comfy sofa set in front of the television. To the south is a classroom.

There is a Happy Clown standing in the corner of the room staring at you. A golden key is dangling from its brightly colored belt.

You can also see a light switch here.

>go south
Classroom
There are two rows of chairs in the classroom. To the north through the a short hallway is a living room. 

There is a laptop with solitaire on the screen resting on the table. It looks valuable. Surely a gift someone would be happy to receive!

You can see a Portal, a table and a treasure chest (closed) here.

There are 20 minutes to escape!

>take laptop
Taken.

There are 20 minutes to escape!

>go north
Living Room
There is a comfy sofa set in front of the television. To the south is a classroom.

There is a Happy Clown standing in the corner of the room staring at you. A golden key is dangling from its brightly colored belt.

You can also see a light switch here.

There are 20 minutes to escape!

>kill clown
Violence isn't the answer to this one.

There are 20 minutes to escape!

>help clown
That's not a verb I recognise.

>take key
That seems to belong to the Happy Clown.

There are 20 minutes to escape!

>give clown laptop
The Happy Clown reaches out to you screaming while making no noise! You hand the clown the laptop and it tosses the key to you.
You also suddenly remember the portal in the classroom. Quick! Use the key to unlock the portal and escape!

There are 7 minutes to escape!

>go south
Classroom
There are two rows of chairs in the classroom. To the north through the a short hallway is a living room. TIME IS RUNNING OUT!

You can see a Portal, a table and a treasure chest (closed) here.

There are 6 minutes to escape!

>unlock portal
(with the golden key)
That doesn't seem to fit the lock.

There are 5 minutes to escape!

>unlock chest
(with the golden key)
You unlock the treasure chest.

There are 4 minutes to escape!

>open chest
You open the treasure chest, revealing an Electro Gadget.

There are 3 minutes to escape!

>take gadget
Taken.

There are 2 minutes to escape!

>unlock portal
What do you want to unlock the Portal with?

>unlock portal with gadget
You unlock the Portal.

There is 1 minutes to escape!

>open portal
You open the Portal.

There are 0 minutes to escape!

>enter portal
Amusement Park
You can see a Portal here.

You didn't make it to the portal. The curse of the golden key consumes you!

    *** The End ***

Would you like to RESTART, RESTORE a saved game, QUIT or UNDO the last command?

>restart
Game 601 11-2-21
An Interactive Fiction by Mike Treanor
Release 1 / Serial number 221123 / Inform 7 v10.1.2 / D

Classroom
There are two rows of chairs in the classroom. To the north through the a short hallway is a living room. 

There is a laptop with solitaire on the screen resting on the table. It looks valuable. Surely a gift someone would be happy to receive!

You can see a Portal, a table and a treasure chest (closed) here.

>take laptop
Taken.

There are 20 minutes to escape!

>go north
Darkness
It is pitch dark, and you can't see a thing.

You see a faint glow coming form a light switch.

There are 20 minutes to escape!

>switch light
You switch the light switch on.

There are 20 minutes to escape!

Living Room
There is a comfy sofa set in front of the television. To the south is a classroom.

There is a Happy Clown standing in the corner of the room staring at you. A golden key is dangling from its brightly colored belt.

You can also see a light switch here.

>give clown laptop
The Happy Clown reaches out to you screaming while making no noise! You hand the clown the laptop and it tosses the key to you.
You also suddenly remember the portal in the classroom. Quick! Use the key to unlock the portal and escape!

There are 7 minutes to escape!

* * *

>go south
Classroom
There are two rows of chairs in the classroom. To the north through the a short hallway is a living room. TIME IS RUNNING OUT!

You can see a Portal, a table and a treasure chest (closed) here.

There are 6 minutes to escape!

>unlock chest with ke
You can't see any such thing.

>unlock chest with key
You unlock the treasure chest.

There are 5 minutes to escape!

>open chest
You open the treasure chest, revealing an Electro Gadget.

There are 4 minutes to escape!

>take gadget
Taken.

There are 3 minutes to escape!

>unlock portal with gadget
You unlock the Portal.

There are 2 minutes to escape!

>enter portal
(first opening the Portal)

Amusement Park
You can see a Portal here.

You made it through portal to the Amusement Park, and look! Your friend the Happy Clown has come to join you laptop in hand! THE END.

    *** The End ***

Would you like to RESTART, RESTORE a saved game, QUIT or UNDO the last command?

* * *

The Cove
An Interactive Fiction by Will Geller
Release 1 / Serial number 221125 / Inform 7 v10.1.2 / D

The Boat
You are adrift a ship with no food and no sail, a storm has sent you close to land... to the west is the beach...

>go south
You can't go that way.

>look
The Boat
You are adrift a ship with no food and no sail, a storm has sent you close to land...

* * *

>go south
You can't go that way.

>go west
Beach room

* * *

The Cove
An Interactive Fiction by Will Geller
Release 1 / Serial number 221125 / Inform 7 v10.1.2 / D

The Boat
You are adrift a ship with no food and no sail, a storm has sent you close to land... to the west is the beach...

>go west
Beach
Finally, you have made it to shore. As your feet hit the sand you feel a sense of relief. Out of the corner of your eye you spot a chest. Further inland you see a Cavern Entrance but it is blocked by rocks.

You can see a Cavern Entrance and a Chest (in which is a shovel) here.

>open chest
It isn't something you can open.

>take key
Taken.

* * *

>go west
Beach
Finally, you have made it to shore. As your feet hit the sand you feel a sense of relief. Out of the corner of your eye you spot a chest. Further inland you see a Cavern Entrance but it is blocked by rocks.

You can see a Cavern Entrance and a Chest (in which is a shovel) here.

>open Cave
It seems to be locked.

* * *

>go west
Beach
Finally, you have made it to shore. As your feet hit the sand you feel a sense of relief. Out of the corner of your eye you spot a chest. Further inland you see a Cavern Entrance but it is blocked by rocks.

You can see a Cavern Entrance and a Chest (in which is a shovel) here.

>take key from chest
Taken.

>open cavern entrance
It seems to be locked.

>unlock cavern entrance
(with the key)
That doesn't seem to fit the lock.

* * *

>go west
Beach
Finally, you have made it to shore. As your feet hit the sand you feel a sense of relief. Out of the corner of your eye you spot a chest. Further inland you see a Cavern Entrance but it is blocked by rocks.

You can see a Cavern Entrance and a Chest (in which is a shovel) here.

>take shovel
Taken.

>open cavern entrance
It seems to be locked.

>open cavern entrance with shovel
You unlock the Cavern Entrance.

>go west
(first opening the Cavern Entrance)

Caverns
You can see a Cavern Entrance here.

You made it to the underwater cave, all around you are piles of pirates gold, congrats u rich now. THE END.

    *** The End ***

Would you like to RESTART, RESTORE a saved game, QUIT or UNDO the last command?

* * *

>take shovel
Taken.

>open caverns
You can't see any such thing.

>open caverns entrance with shovel
You can't see any such thing.

* * *

The Cove
An Interactive Fiction by Will Geller
Release 1 / Serial number 221125 / Inform 7 v10.1.2 / D

The Boat
You are adrift a ship with no food and no sail, a storm has sent you close to land... to the west is the beach...

>test me
>--> The following tests are available:
'test win'

>test win
(Testing.)

>[1] go west

Beach
Finally, you have made it to shore. As your feet hit the sand you feel a sense of relief. Out of the corner of your eye you spot a chest. Further inland you see a Cavern Entrance but it is blocked by rocks.

You can see a Cave Entrance and a Chest (in which is a shovel) here.

>[2] take shovel
Taken.

>[3] open cave entrance with shovel
You unlock the Cave Entrance.

>[4] go west
(first opening the Cave Entrance)

Caverns
You can see a Cave Entrance here.

You enter the caverns and swim deeper into the depths of the cave. Something compels you to explore further. After a brief swim you enter a new chamber, within the chamber a light illuminates a glowing stash of gems! You take the gems back to shore, now hoping for someone to come by to rescue you. Maybe then your gems will come to be of value!

    *** The End ***

Would you like to RESTART, RESTORE a saved game, QUIT or UNDO the last command?

>restart
The Cove
An Interactive Fiction by Will Geller
Release 1 / Serial number 221125 / Inform 7 v10.1.2 / D

The Boat
You are adrift a ship with no food and no sail, a storm has sent you close to land... to the west is the beach...

>go west
Beach
Finally, you have made it to shore. As your feet hit the sand you feel a sense of relief. Out of the corner of your eye you spot a chest. Further inland you see a Cavern Entrance but it is blocked by rocks.

You can see a Cave Entrance and a Chest (in which is a shovel) here.

>open chest
It isn't something you can open.

>go to cave
You can't see any such thing.

>pick up shovel
Taken.

>open chest with shovel
That doesn't seem to be something you can unlock.

>go to cave with shovel
You can't see any such thing.

>go to cavern entrance
You can't see any such thing.

>go to cavern entrance with shovel
You can't see any such thing.

>go west
(first opening the Cave Entrance)
It seems to be locked.

>use shovel
That's not a verb I recognise.

>unlock with shovel
You can't see any such thing.

>unlock cavern entrance
You can't see any such thing.

>open Cavern Entrance with shovel
You can't see any such thing.

>go west
(first opening the Cave Entrance)
It seems to be locked.

>open Cave Entrance
It seems to be locked.

>unlock Cave Entrance
(with the shovel)
You unlock the Cave Entrance.

>go west
(first opening the Cave Entrance)

Caverns
You can see a Cave Entrance here.

You enter the caverns and swim deeper into the depths of the cave. Something compels you to explore further. After a brief swim you enter a new chamber, within the chamber a light illuminates a glowing stash of gems! You take the gems back to shore, now hoping for someone to come by to rescue you. Maybe then your gems will come to be of value!

    *** The End ***

Would you like to RESTART, RESTORE a saved game, QUIT or UNDO the last command?